ssssssssssssssssssssssssssssss
000000000000000000000000000000
0000x00000x00000000x00000x0000
0000x00000x00000000x00000x0000
0000x00000x00000000x00000x0000
0000xxxxxxx00000000xxxxxxx0000
000000000000000000000000000000
000000000000000000000000000000
000000000000000000000000000000
xxxxx00000xxxxxxxxxx00000xxxxx
0000x00000000000000x0000000000
0000x00000000000000x0000000000
0000x00000000000000x0000000000
0000xxxxxxx00000000xxxxxxx0000
000000000000000000000000000000
000000000000000000000000000000
ffffffffffffffffffffffffffffff
